Object: Stage

#Name
Name: Turkey Jungle

#Object Definitions
O: empty
B: empty
G: empty
E: empty

P: /resources/objects/characters/fluffy1.txt
1: /resources/objects/characters/rooster1.txt
2: /resources/objects/characters/snail1.txt
3: /resources/objects/characters/crab1.txt
4: /resources/objects/characters/turkey.txt
5: /resources/objects/characters/emu.txt

*: /resources/objects/item_coin.txt
+: /resources/objects/item_health.txt
>: /resources/objects/item_speed_boost.txt
^: /resources/objects/item_jump_boost.txt
-: /resources/objects/item_bomb.txt
@: /resources/objects/item_goal.txt


#Map file
TileMap: /resources/objects/stages/map9.txt

#Map Description
Row1:  EEEEOOOOOOOOOOOOOOOOOOOOOOOOOOOOOOOOOOOOOOOOOOOOOOOOOOOOOOOOOOOOOOOOOOOOOOOOOOOOOOOOOOOOOOOOOOBBOOOOOOOOOOOOOOOOOOOOOOOOOOOOOOOOOOOOOOOOOOOOOOOOOOOOOOOOOOOEEE
Row2:  EOOOOOOOOOOOOOOOOOOOOOOOOOOOO4OOOOOOOOOOOOOOOOOOOOOOOOOOOOOOOOOOOOOOOOOOOOOOOOOOOOOOOOOOOOOOOOBBOOOOOOOOOOOOOOOOOOOOOOOOOOOOOOOOOOOOOOOOOOOOOOOOOOOOOOOOOOOOOE
Row3:  EOOOOOOOOOOOOOO****OOOO****OOOO****OOOO****OOOOOOOOOOOOOOOOOOOOOOOOOOOOOOOOOOOOOOOOOOOOOOOOOOOBBOOOOOOOOOOOOOOOOOOOOOOOOOOOOOOOOOOOOOOOOOOOOOOOOOOOOOOOOOOOOOE
Row4:  EOOPOOOOOOOOOGGGGGGGGGGGGGGGGGGGGGGGGGGGGGGGGGOOOOOOOOOOOOOOOOOOOOOOOOOOOOOO5OOOOOOOOOO++O3++OBBOO@OOOOOOOO4OOOOOOOOOOOOOO***********OOOOOOOOOOOOOOOOOOOOOOOOE
Row5:  EOOOOOOOOOOOOOOOOOOOOOOOOOOOOOOOOOOOOOOOOOOOOOOOOOOOOOOOOOOO4OOGGGGGGGGGGGGGGGGGGGGGOOGGGGGGGGBBGGGGGGGGGGGGGGGGGGGGGGGGGGGGGGGGGGGGGGGGGGGGGGGGGGGG2OOOOOOOOE
Row6:  GGGGGGGGGGOOOOOOOOOOOOOOOOOOOOOOOOOOOOOOO5OOOOO++++OOOOGGGGGGGGBBBBBBBBBBBBBBBBBBBBBOOBBBBBBBBBBOOOOOOOOOOOOOOOOOOOOOOOOOOOOOOOOOOOOOOOOOOOOOOOOOOOBGGGGOOOOOE
Row7:  BBBBBBBBBBOOOOOOOOOOOOOOOOOOOGGGGGGGGGGGGGGGGGGGGGGGGGGBBBBBBBBBBBBBBBBBBBBBBBBBBBBBOOOOOOOOOOOOOOOOOOOOOOOOOOOOOOOOOOOOOOOOOOOOOOOOOOOOOOOOOOOOOOOOOOOOOOOOOE
Row8:  BBBBBBBBBBOOOOOOOOOO4OOOOOOOOBBBBBBBBBBBBBBBBBBBBBBBBBBBBBBBBBBBBBBBBBBBBBBBBBBBBBBBOOOOOOOOOOOOOOOOOOOOOO4OOOOOOOOOOOOOO++OOOOOOOOOOOOOOOOOOOOOOOOOOOO4OOOOOE
Row9:  BBBBBBBBBBGGGGGGGGGGGGGGGGGGGBBBBBBBBBBBBBBBBBBBBBBBBBBBBBBBBBBBBBBBBBBBBBBBBBBBBBBBGGGGGGGGGGGGGGGGGGGGGGGGGGGGGGGGGGGGGGGGGGGGGGGGGGGGGGGGGGGGGGGGGGGGGGGGGE
Row10: BBBBBBBBBBOOOOOOOOOOOOOOOOOOOOOOOOOOOOOOOOOOOOOOOOOOOOOOOOOOOOOOOOOOOOOOOOOOOOOOOOOOOOOOOOOOOOOOOOOOOOOOOOOOOOOOOOOOOOOOOOOOOOOOOOOOOOOOOOOOOOOOOOOOOOOOOOOOOE
Row11: BBBBBBBBBOOOOOOOOOOOOOOOOOOOOOOOOOOOOOOOOOOOOOOOOOOOOOOOOOOOOOOOOOOOOOOOOOOOOOOOOOOOOOOOOOOOOOOOOOOOOOOOOOOOOOOOOOOOOOOOOOOOOOOOOOOOOOOOOOOOOOOOOOOOOOOOOOOOOE


#Physics
Gravity: 0.002