Object: Stage

#Name
Name: Emu Castle
#Object Definitions
O: empty
B: empty
G: empty
E: empty

P: /resources/objects/characters/fluffy1.txt
1: /resources/objects/characters/rooster1.txt
2: /resources/objects/characters/snail1.txt
3: /resources/objects/characters/crab1.txt
4: /resources/objects/characters/turkey.txt
5: /resources/objects/characters/emu.txt

*: /resources/objects/item_coin.txt
+: /resources/objects/item_health.txt
>: /resources/objects/item_speed_boost.txt
^: /resources/objects/item_jump_boost.txt
-: /resources/objects/item_bomb.txt
@: /resources/objects/item_goal.txt


#Map file
TileMap: /resources/objects/stages/map6.txt

#Map Description
Row1:  EOOOOOOOOOOOOOOOOOOOOOOOOOOOOOOOOOOOOOOOOOOOOOOOOOOOOOOOOOOOOOOOOOOOOOOOOOOOOOOOOOOOOOOOOOOOOOOOOOOOOOOOOOOOOOOOOOOOOOOOOOOOOOOOOOOOOOOOOOOOOOOOOOOOOOOOOOOOOOOOOOOOOOOOOOOOOOOOOOOOOOOOOOOOOOOOOOOOOOOOOOOOOOOOOOOOOE
Row2:  EOOOOOOOOOOOOOOOOOOOOOOOOOOOOOOOOOOOOOOOOOOOOOOOOOOOOOOOOOOOOOOOOOOOOOOOOOOOOOOOOOOOOOOOOOOOOOOOOOOOOOOOOOOOOOOOOOOOOOOOOOOOOOOOOOOOOOOOOOOOOOOOOOOOOOOOOOOOOOOOOOOOOOOOOOOOOOOOOOOOOOOOOOOOOOOOOOOOOOOOOOOOOOOOOOOOOE
Row3:  EOOOOPOOOOOOOOOOOOOOOOOOOOOOOOOOOOOOOOOOOOOOOOOOOOO^OOOOOOOOOOOOOOOOO5OO++++OOOOOOOOOOOOOOOOOOOOOOOOOOOOOOOOOOOOOO******5*********OOOOOOOOOOOOOOOOOOOOOOOOOOOOOOOOOOOOOOOOOOOOOOOOOOOOOOOO5OO******OOOOOOOOOOOOOOOOOOE
Row4:  EOOOOOOOOOOOOOOOOOOOOOOOOOOOOOOOOOOOOOOOOOOOOOOOOOOOOOOOOOOOOGGGGGGGGGGGGGGGGGOOOOOOOOOOOOOOOOOOOOOOOOOOOOOOOOGGGGGGGGGGGGGGGGGGGGGGGGGOOOOOOOOOOOOOOOOOOOOOOOOOOOOOOOOOOOOOOOOOOOGGGGGGGGGGGGGGGGGGGGGOOOOOOOOOOOOOOE
Row5:  EGGGGGGGGGGGGOOOOOOOOOOOOOOOOOOOOOOOOOOOOOOOOOOOOOOOOOOOOOOOOBBBBBBBBBBBBBBBBBOOOOOOOOOOOOOOOOOOOOOOOOOOOOGGGGBBBBBBBBBBBBBBBBBBBBBBBBBGGGGOOOOOOOOOOOOOOOOOOOOOOOOOOOO******OOOOOOOOOOOOOOOOOOOOOOOOOOOOOOOOOOOOOOOOE
Row6:  EBBBBBBBBBBBBOOOOOOOOOOOOOOOOOOOOOOOOOOOOOOOOOOO5OOOOOOOOOOOOBBBBBBBBBBBBBBBBBOOOOOOOOOOOOO5OOOO++++OOGGGGBBBBBBBBBBBBBBBBBBBBBBBBBBBBBBBBBGGGGOOOOOOOOOOOOOOOOOOOOOOOGGGGGGGGOOOOOOOOOOOOOOOOOOOOOOOOOOOOOOOOOOOOOOOE
Row7:  EBBBBBBBBBBBBOOOOOOOOOOOOOOOOOOOOOOOOOGGGGGGGGGGGGGGGGGOOOOOOBBBBBBBBBBBBBBBBBOOOOOOGGGGGGGGGGGGGGGGGGBBBBBBBBBBBBBBBBBBBBBBBBBBBBBBBBBBBBBBBBBGGGGOOOOOOOOOOOOOOOOOOOOOOOOOOOOOOOOOOOOOOOOOOOOOOOOOOOOOOOOOOOOOO@OOOE
Row8:  EBBBBBBBBBBBBOOOOOOOOOOOOO5OOOOOOOOOOOBBBBBBBBBBBBBBBBBOOOOOOBBBBBBBBBBBBBBBBBOOOOOOBBBBBBBBBBBBBBBBBBBBBBBBBBBBBBBBBBBBBBBBBBBBBBBBBBBBBBBBBBBBBBBGGGGOOOOOOOOOOOOOOOOOOOOOOOOO5OOOOOOOOOOOOOOOOOOOOOOOOOOO5OOOOOOOOE
Row9:  EBBBBBBBBBBBBOOOOOOGGGGGGGGGGGGGGOOOOOBBBBBBBBBBBBBBBBBOOOOOOBBBBBBBBBBBBBBBBBOOOOOOBBBBBBBBBBBBBBBBBBBBBBBBBBBBBBBBBBBBBBBBBBBBBBBBBBBBBBBBBBBBBBBBBBBGGGGGGGGGGGGGGGGGGGGGGGGGGGGGGGGGOOOOGGOOOOGGGGGGGGGGGGGGGGGGGE
Row10: EBBBBBBBBBBBBOOOOOOBBBBBBBBBBBBBBOOOOOBBBBBBBBBBBBBBBBBOOOOOOBBBBBBBBBBBBBBBBBOOOOOOBBBBBBBBBBBBBBBBBBBBBBBBBBBBBBBBBBBBBBBBBBBBBBBBBBBBBBBBBBBBBBBBBBBBBBBBBBBBBBBBBBBBBBBBBBBBBBBBBBBBOOOOBBOOOOBBBBBBBBBBBBBBBBBBBE
Row11: EBBBBBBBBBBBBOOOOOOBBBBBBBBBBBBBBOOOOOBBBBBBBBBBBBBBBBBOOOOOOBBBBBBBBBBBBBBBBBOOOOOOBBBBBBBBBBBBBBBBBBBBBBBBBBBBBBBBBBBBBBBBBBBBBBBBBBBBBBBBBBBBBBBBBBBBBBBBBBBBBBBBBBBBBBBBBBBBBBBBBBBBOOOOBBOOOOBBBBBBBBBBBBBBBBBBBE


#Physics
Gravity: 0.002