Object: Stage

#Name
Name: Krab Kingdom

#Object Definitions
O: empty
B: empty
G: empty
E: empty

P: /resources/objects/characters/fluffy1.txt
1: /resources/objects/characters/rooster1.txt
2: /resources/objects/characters/snail1.txt
3: /resources/objects/characters/crab1.txt
4: /resources/objects/characters/turkey.txt

*: /resources/objects/item_coin.txt
+: /resources/objects/item_health.txt
>: /resources/objects/item_speed_boost.txt
^: /resources/objects/item_jump_boost.txt
-: /resources/objects/item_bomb.txt
@: /resources/objects/item_goal.txt


#Map file
TileMap: /resources/objects/stages/map2.txt

#Map Description
#Map Description
Row1:  EOOOOOOOOOOOOOOOOOOOOOOOOOOOOOOOOO3OOOOOOOOOOOOOOOOOOOOOOOOOOOOOOOOOOOOOOOOOOOOOOOOOOOOOOOOOOOOOOOOOOOOOOOOOOOOOOOOOOOOOOOOOOOOOOOOOOOOOOOOOOOOOOOOOOOOOOOOOOE
Row2:  EOOOOOOOOOOOOOOOOOOOO3OOOOOOOOO*******OOOOOOOOOOOOOOOOOOOOOOOOOOOOOOOOOOO3OOOOOOOOOOOOOOOOOOOOOOOOOOOOOOOOOOOOOOOOOOOOOOOOOOOOOOOOOOOOOOOOOOOOOOOOOOOOOOOOOOOE
Row3:  EOOOOOOOOOOOOOOOOGGGGGGGGOOOOOOOOOOOOOOOOOOOOOOOOOOOOOOOOOOOOOOOOOOOOO*******OOOOOOOOOOOOOOOOOOOOOOOOOOOOO2OOOOOOOOOOOOO+OOOOO-OOOOOOOOOOOOOOOOOOOOOOOOOOOOOOE
Row4:  EOOOOOOOOOOOOOOOGBBBBBBBBOOOOOOBBBBBBBOOOOOOOOOOOOOOOOOOOOOOOOOOOOOOOOBBBBBBBOOOOOOOOOOOOOOOOOOOOOOOOOBBBBBBBBBBOOOOOOOBBOOOOBBBOOOOBBOOOOOOOOO******OOOOOO@OE
Row5:  EOOOOOOOOOOOOOOGBBBBBBBBBOOOOOOOOOOOOOOOOOOOOOOOOOOOOOOOOOOOOOO2OOOOOOOOOOOOOOOOOOOOOOOOOOOOOOBBBOOOOOOOOOOOOOOOOOOOOOOOOOOOOOOOOOOOOOOOOOOOOOO******OOOOOOOOE
Row6:  EOOOOOOOOOOOOOGBBBBBBBBBBOOOOOOOOOOOOOOOOOOOOOOOOOOOOOOOOOOBBBBBBBOOOOOOOOOOOOOOOOOOOOOO3OOOOOOOOOOOOOOOOOOOOOOOOOOOOOOOOOOOOOOOOOOOOOOGGGGGGGGGGGGGGGGGGGGGGE
Row7:  EOOPOOOOOOOOOGBBBBBBBBBBBOOOOOOOOOOOOOOOOOOOOOOOOOOOOOOOOOOOOOOOOOOOOOOOOOOOOOOOOOOOOOBBBBOOOOOOOOOOOOOOOOOOOOOOOOOOOOOOOOOOOOOOOOOOOOOBBBBBBBBBBBBBBBBBBBBBBE
Row8:  EOOOOOOOOOOOGBBBBBBBBBBBBOOOOOOOOO2OOOOOOOOOOOOOOOOO3OOOOOOOOOOOOOOOOOOOOOOO+O+O+OOOOOOOOOOOOOOOOOOOOOOOOOOOOOOOOOOOOOOOOOOOOOOOOOOOOOOBBBBBBBBBBBBBBBBBBBBBBE
Row9:  EGGGGGGGGGGGBBBBBGGGGGGGGGGGGGGGGGGGGGGGGGGGGGGGGGGGGGGGGGGGGGGGGGGGGGGGGGGGGGGGGGGGOOOOOOOOOOOOOOOOOOOOOOOOOOOOOOOOOOOOOOOOOOOOOOOOOOOBBBBBBBBBBBBBBBBBBBBBBE
Row10: EOOOOOOOOOOOOOOOOOOOOOOOOOOOOOOOOOOOOOOOOOOOOOOOOOOOOOOOOOOOOOOOOOOOOOOOOOOOOOOOOOOOOOOOOOOOOOOOOOOOOOOOOOOOOOOOOOOOOOOOOOOOOOOOOOOOOOOOOOOOOOOOOOOOOOOOOOOOOE
Row11: EOOOOOOOOOOOOOOOOOOOOOOOOOOOOOOOOOOOOOOOOOOOOOOOOOOOOOOOOOOOOOOOOOOOOOOOOOOOOOOOOOOOOOOOOOOOOOOOOOOOOOOOOOOOOOOOOOOOOOOOOOOOOOOOOOOOOOOOOOOOOOOOOOOOOOOOOOOOOE


#Physics
Gravity: 0.002